먹을까요?	eat?
먹읍시다	eat
찍을까요?	take?
찍읍시다	take
읽을까요?	read?
읽읍시다	read
갈까요?	go?
갑시다	go
만날까요?	meet?
만납시다	meet
쉴까요?	rest?
쉽시다	rest
팔까요?	sell?
팝시다	sell
살까요?	live?
삽시다	live
만들까요?	make?
만듭시다	make
공부할까요?	study?
공부합시다	study
전화할까요?	call?
전화합시다	call
이야기할까요?	chat?
이야기합시다	chat
